NO assets/door.xpm
SO assets/door.xpm
WE assets/door.xpm
EA assets/door.xpm
F 220,100,0
C 00,0,0


11111111111111111111111111111
11000000000000000000000000011
11000001110000000011100000011
11000001101110011101100000011
11000001100001100001100000011
11000001100000000001100000011
11000001100000000001100000011
11000001100000000001100000011
11000001100000000001100000011
110W0000000000000000000000011
11000000000000000000000000011
11111111111111111111111111111