NO assets/door.xpm
SO assets/door.xpm
WE assets/door.xpm
EA assets/door.xpm
F 220,100,0
C 00,0,0


1111111
11E0011
1111111
1111111
1111111
1111111
1111111
1111111
1111111
1111111
1111111
1111111