NO assets/door.xpm
SO assets/door.xpm
WE assets/door.xpm
EA assets/door.xpm
F 220,100,0
C 00,0,0


1111111111111111111
11N0000000000001111
1100000000000011111
1110000000000000111
1110000000000001111
1110000000000001111
1111000011000011111
1111000000000111111
1111111100000011111
1111110011111111111
1111111100111111111
1111111111111111111